{
  "width": 8,
  "height": 4,
  "spawnX": 1.0,
  "spawnY": 1.0,
  "goalX": 6.0,
  "goalY": 1.0,
  "background": [
    9, 9, 9, 9, 9, 9, 9, 9,
    9, 9, 9, 9, 9, 9, 9, 9,
    0, 0, 0, 0, 0, 0, 0, 0,
    0, 0, 0, 0, 0, 0, 0, 0
  ],
  "foliage": [
    0, 0, 0, 0, 0, 0, 0, 0,
    0, 0, 0, 0, 0, 0, 0, 0,
    0, 0, 0, 0, 0, 0, 0, 0,
    1, 1, 1, 1, 1, 1, 1, 1
  ],
  "foreground": [
    0, 0, 0, 0, 0, 0, 0, 0,
    0, 0, 0, 0, 0, 0, 0, 0,
    0, 0, 0, 0, 0, 0, 0, 0,
    0, 0, 0, 0, 0, 0, 0, 0
  ]
}
